111111
1P0001
1000E1
100001
111111