11111111111111111111
11110111111111000011
111000011P1100000011
1100C000111000010001
100111000000C1110001
1011000000011110001
10110000000011111111
101000C0111110100011
1C10011110001010E111
11111111111111111111