11111111111
100C0100101
1010P001101
1100C00P101
1E011100001
11111111111