11111111
1P001111
1C0EX0C1
11111111