111111111111111111111111
1E000CCC000000CCCC0000P1
111111111111111111111111